#############################
#                          A#
#              ##############
#                           #
#          X D           P  #
#                           #
#          D X     ##########
#                   #       #
##########          #       #
#       A#          #   #   #
#       O#          #   #   #
#    #####          #   #   #
#                       #   #
#                       #  O#
#############################