########
#    P #
#    D #
#OX    #
#   A  #
########