#####
# P #
# O #
# X #
#  T#
#####  #################
       #I              #
       #       X    C  #
       #               #
       #              C#
       ########ZZZ######
       #               #
       #               #
       #               #
       #            O  #
       #################