##################################
#                           X  O #
#   P     #   X       X          #
#         ##########    ####     #
#   X   ###        #    #        #
#             ###  #    #######  #
#############      #    #O  #    #
# O #     O #  O   # O  #  #     #
#   #  X    ######## #####       #
#   #       #       O#    X      #
#   ###  X    X  ### #           #
#                               O#
##################################