#####
#O T#
#X#P#
#   #
#####

   #####
   #  I#
   # X #
   # O #
   #####